# Level 10 - Mê cung
XXXXXXXXXXXX
XX000000000X
XX033333300X
XX033333300X
XXXXXXXXXXXX
