# Level 7 - Tường bất diệt ở giữa
111XX111XX11
222XX222XX22
333XX333XX33
222XX222XX22
111XX111XX11
