00A000A000A0
0S0S0S0S000S
A00A00A00A00
0H0000000000
0S00S00S00H0
00A000A000A0
