000G111G0000
000G000G0000
000G000G0000
000G0K0G0000
000000000000
