# Level 12 - Khó với nhiều bất diệt
XX3333333XX0
XX2222222XX0
XXXXXXXXXXXX
XX2222222XX0
XX3333333XX0
