# Level 9 - Pattern xen kẽ
XXXXXXXXXXXX
333333333333
222222222222
333333333333
XXXXXXXXXXXX
