# Level 6 - Xuất hiện gạch bất diệt
111111111111
222222222222
XXXXXXXXXXXX
222222222222
111111111111
