BBBABGGBABBB
A0A0A00A0A0A
000B0000B0BO
BGBBB00BBBGB
B0B0B00BB00B